1111111111
1011000001
1010000111
1000000011
1000000001
1000000001
1000000001
1010000101
1100000011
1111111111